ABSTALE: wale
ACHTE: gheslachte crachte
ACHTER: lachter
ACHTERWAERT: reynaert
ACHTRE: lachtre lachtre
AERMIJNC: vinc coninc
AF: caf gaf
AFGHEBETEN: weten
AFGHEDAEN: gaen
AFGHESLEGHEN: pleghen
AFLAET: daet upgaet staet vlucht
AFLATE: bate
AFVLOYDE: ontscoyde
AGHEDOCHTE: brochte
AKEN: gheraken
AL: ongheval ongheval gheval gheval sal sal sal ongheval
ALGADER: vader vader vader vader
ALGADRE: vadre
ALLEENE: cleene beene steene
ALLEGADER: vader
ALLEGADRE: vadre
ALLEN: ghevallen ghevallen ghevallen
ALRESCAERPST: warp
ALS: hals
ALSO: stro vro
ALTOES: scadeloes
AMEEN: been
AN: molenman can man man ontgan began
ANDREN: wandelen wandelen
ANDWOERDE: verhoerde
ANDWOERDEN: woerden
ANE: vane
ANESLAEN: ghedaen
ANGAEN: ontfaen
ANSCHIJN: zijn
ANSCHINE: pine
ANXT: lancst
APEERT: gheleert
APRILLE: onwille
ARGERTIEREN: dieren
ASE: hase
AT: dat
AUTARE: vare
AVONTUERE: muere
AVONTUEREN: creatuere
BADE: spade
BADEN: weldaden
BAERDE: reynaerde reynaerde reynaerde reynaerde
BAERKEN: maerken
BAERT: reynaert
BAKE: smake ghemake
BALGHE: galghe
BALLINGHE: wandelinghe
BAN: man ontran dan
BARAET: quaet raet verstaet dagheraet
BARATE: strate hate
BARATEN: verwaten
BARBECANE: gane
BARE: ghevaren zware mare niemare
BAREN: mare waren waren
BAROENE: doene
BAT: dat dat scat
BATE: aflate
BAVE: stave
BECAREMDE: ontfaremde
BECLAGHET: daghet ghedaghet
BECOEPEN: belopen gheloepen loepen loepen beloepen loepen
BEDACHT: nacht
BEDOCHT: brocht
BEDRAGEN: maghen
BEDRAGHEN: maghen
BEDREGHEN: beteghen
BEDRIEGHEN: lieghen
BEDROGHEN: gheloghen moghen moghen gheloghen
BEDROUCH: slouch
BEDROUGHEN: ghenoughen
BEDWANC: ganc cranc ghemanc
BEDWINGHEN: ghinghen
BEEDE: crede leede onghereede gheleede
BEEN: scheen ameen neen sceen
BEENE: overeene alleene
BEERE: heere heere heere
BEEREHUUT: druut
BEET: cleet
BEGAERT: waert
BEGAN: gram an
BEGHEERDE: dheerde
BEGHEERDIJT: tijt
BEGHEVEN: leven gheheven upheven tleven leven
BEGHIET: niet
BEGHIN: zin
BEGHINNEHOFDAG: sinne
BEGHINNEN: ghewinnen
BEGONNEN: jonnen zonnen nonnen
BEGRAVEN: scraven scraven
BEHOUDEN: houden
BEIDE: lamfreyde
BEIDEN: heiden sceiden
BEJACH: lach
BEJAGHEDEN: lagheden
BEJAGHEN: draghen
BEJAGHET: ghecnaghet
BEKINDE: gheninde
BEKINNEN: binnen
BELAGHEN: maghen
BELGHEDI: mi
BELIJN: zijn zijn
BELIJNS: zijns
BELINE: stillekine pine
BELOEPEN: becoepen
BELOKEN: tebroken
BELOPEN: becoepen
BEM: hem hem hem hem hem hem hem hem
BENDEN: hersenden
BEQUAME: hamen
BEQUAMEN: namen
BERADEN: laden saden scaden daden
BERIEDEN: lieden
BERIET: niet niet
BERINGHET: ghedinghet
BESAT: scat
BESCAERMEN: ontfaermen
BESCAUWEN: teblauwen
BESCOREN: verloren tevoren
BESPIET: niet
BESPRAKEN: ghewraken
BESPREKEN: ghewreken
BEST: lust
BESTAEN: ghegaen vergaen waen ghedaen saen
BESTAET: gaet
BESTE: veste
BESTOET: moet
BESTOLEN: verholen
BET: vet martinet
BETEGHEN: bedreghen
BEVAEN: ghedaen ghegaen waen
BEVE: neve
BEVELEN: telen
BEWAENT: maent
BEWANT: vant
BI: sechdi di di mi hi hi mi merkedi ghi
BIER: fier
BIJLEN: wijlen
BIJSPEL: wel
BINNEN: ghewinnen bekinnen ghewinnen ghewinnen
BLANDEN: scanden
BLARE: openbare
BLASE: hase
BLAUWEN: entrauwen
BLEEF: verdreef
BLEETEN: gheeten
BLENDEN: ontwenden
BLEVE: neve
BLEVEN: vulscreven ghedreven vergheven neven gheven
BLIDE: wijde strijde
BLIVEN: driven driven
BLOEDE: moede
BLOET: stoet goet goets
BLOODE: noode
BLOOT: groot
BLOYS: vermendoys
BODE: gode gode
BOEM: goem goem oem stroem oem
BORGHE: zorghe
BORGHEN: zorghen
BOTTELGIER: hier
BOUCKEN: soucken
BOUCSTAVE: grave
BOUDE: soude
BOVEN: gheloven
BRAC: instac
BRADEN: scaden
BRAEUWEN: claeuwen
BRAKE: zake
BREET: ghereet
BREKEN: ghewreken
BRIEF: dief lief lief
BRIEVE: dieve lieve
BRINGHE: ghedinghe
BRINGHEN: zinghen dwinghen
BROCHT: bedocht mocht
BROCHTE: mochte wrochte haghedochte aghedochte mochte
BROEDE: vroede hoede
BRUGGHE: rugghe
BRUNE: tune crune crune crune cloestercrune crune
BRUNEEL: butseel
BRUUN: tuun tuun
BUSANT: tehant
BUTSEEL: bruneel rosseel
CAF: af
CALF: half
CAN: an man nochtan dan man
CANTAERT: waert
CANTECLEER: vorwaertmeer
CANTICLEER: meer
CAPELAEN: gaen ghedaen
CAPPOEN: hoen hoen
CAPPROEN: doen
CARINE: scinen
CARMEDE: ontfaermede
CARMINGHE: ghedinghe
CASTYEN: vermalendyen
CATER: mater water
CLAERT: vaert
CLAEUWEN: braeuwen
CLAGHE: maghe daghe daghe
CLAGHEN: waghen maghen daghen maghen
CLAREN: varen
CLEENE: alleene eene ghemeene steene ghemeene
CLEENEBEJACH: vederslach
CLEET: beet
CLERC: werc werc
CLOCKELIJNEN: pinen
CLOCKEN: julocken
CLOESTER: noster
CLOESTERBIER: hier
CLOESTERCRUNE: brune
CLOET: lancvoet
CLOETE: voete
CLUSENARE: ware zware
CNOEPEN: loepen
COENE: groene doene doene doene hoene doene zoene
COEPEN: ommeloepen
COME: some
COMEDI: hi
COMEN: ghenomen ghenomen vromen vernomen vromen zomen vernomen vromen vernomen vernomen zoenen
CONDEN: zonden
CONINC: rinc ontfinc rijnc hinc dinc dinc aermijnc dinc ghinc dinc
CONINCLIKE: rike
CONINGHINNE: verwinnen zinne zinne ghewinne zinne mynnen zinne zinnen zinne zinne zinne
CONINGHINNEN: ghewinnen
CONNEN: ghewonnen
CONSTE: jonste
CONT: stont
CONVENT: omtrent
COPPE: croppe
CORTOYS: francsoys
COUDE: woude menichfoude
COVENT: ghenent
CRACHT: gracht ommacht nacht nacht nacht nacht ommacht
CRACHTE: achte
CRAGHE: daghe draghe
CRAMP: scamp
CRANC: bedwanc
CRAYANT: vant
CREATUERE: avontueren muere
CREDE: gheleede beede ghesceede
CRONE: scone
CRONEN: lonen
CROP: strop
CROPPE: coppe
CRUNE: brune brune brune brune
CRUPEN: stupen cupen
CRUUSSTAF: gaf slach
CRUUT: scuvuut
CUAERDE: reynaerde
CUAERT: reynaert
CUPEN: crupen
CUWAERT: vaert waert
DACH: mach sach ghelach mach mach slach sach sach mach mach
DADE: rade rade rade
DADEN: verraden beraden
DAER: waer waer zwaer zwaer jaer waer waer jaer
DAERAN: nochtan
DAERBI: hi
DAERIN: ghewin ghewin
DAERNARE: vare
DAEROMTRENT: payment
DAERTOE: ghedoe
DAERWAERT: reynaert
DAET: aflaet raet quaet
DAGHE: haghe laghe haghe laghe claghe mi saghe laghe claghe craghe
DAGHEN: maghen voertdraghen claghen
DAGHERAET: raet baraet
DAGHET: beclaghet
DALE: tale male tale tale
DAN: man can man ban
DANC: lanc ontspranc spranc
DANCKEN: lancken wijdelancken
DANEN: hanen wanen
DAREN: ghevaren
DAS: was was was was was was was was was was was was
DASSEN: sassen
DAT: zat sat rat gat gat at scat bat scat scat scat scat bat voerttrac
DEDE: zede vrede ghebede mede lede mede mede ghebeden leden ghebede zede
DEEL: fyrapeel fierapeel fyrapeel
DEELE: muzeele
DEKEN: weken
DELIJT: zijt
DES: es es es
DESEN: wesen wesen ghi wesen wesen ghewesen
DHEERDE: begheerde
DI: bi bi mi
DICHTEN: lichten
DICKE: micke ghemicke
DIEF: lief grief brief lief lief lief
DIEN: versien
DIENT: vrient
DIEP: liep liep
DIER: hier lier lier lier fier hier hier fier hier
DIERE: riviere riviere
DIEREN: playdieren goedertiere argertieren goedertieren
DIES: verlies verlies ries
DIEVE: brieve
DINC: coninc coninc hinc coninc coninc verghinc
DINGHE: ghedinghe ringhe
DINGHEN: manghelinghe vulbringhen ghinghen
DIT: kriekepit wit verbit
DOCHTE: vermochte mochte
DOE: toe vroe vroe toe
DOEN: capproen venisoen hoen lyoen scoen scoen scoen scoen scoen lyoen
DOENE: noene coene coene baroene coene coene zoene
DOET: goet goet vroet moet moet groet vroet goet goet ghemoet moet
DOGHET: verhoghet
DOLE: hole
DOMINO: ho
DOMINUS: huus
DOMSDAGHE: maghe
DOODEN: roden
DOOT: groot gheboot roet groet noot groet noet groot groot
DOREN: horen horen
DORPE: worpe
DORPERHEIT: gheseit
DOVEN: stoven
DRAGHE: craghe
DRAGHEN: waghen maghen bejaghen
DRAGHET: maghet
DRIE: ghescie
DRINEKEN: scijncken
DRIVEN: bliven bliven
DROEVER: hoever
DROUCH: ghenouch ghenouch ghenouch
DRUUT: beerehuut
DULEN: mulen
DWAEN: mesdaen
DWINGHEN: bringhen
DWONGHE: jonghe
DYSERE: rijsere
ECHT: lecht recht recht
EECKEN: smeeken
EEN: sceen
EENE: cleene
EER: meer
EERCHEDE: lede
EERE: heere meere heere heere heeren heere heere meere heere heere zeere
EEREN: keeren heeren keeren
EEWELIKE: rike
ELMARE: hare ware
ELMAREN: waren
EMMERMEER: wederkeer
ENTRAUWEN: blauwen
ERMELIJNEN: welpekijnen
ERMELINE: vogheline
ERRE: verre verre verre verre
ERREDE: merrede
ES: ghewes des des gheles des
EVERZWIJN: tyecelijn
FEL: wel wale wel
FELLE: gheselle gheselle
FELLEN: vertellen
FIER: dier bier dier
FIERAPEEL: deel
FILYE: wijle
FINE: zine
FRANCSOYS: cortoys
FYRAPEEL: deel deel
GAEN: mesdaen capelaen ghestaen staen waen afghedaen ghedaen ontgaen gedaen saen saen ghedaen saen ghestaen ghedaen ghedaen ontfaen saen ontfaen staen staen gevaen verstaen verstaen saen ontfaen
GAENDE: slaende
GAERDELINE: reynaerdine
GAET: bestaet raet quaet raet staet staet staet quaet
GAF: cruusstaf af staf
GALGHE: balghe
GANC: sanc lanc lanc bedwanc
GANE: barbecane
GAST: vast vast
GASTE: vaste vaste
GAT: lat sat dat dat scat
GATE: strate utermaten
GAWY: hawy
GEDAEN: gaen
GELATEN: straten
GEVAEN: gaen
GHAL: ongheval
GHANE: hane ghevane
GHEBARE: ware
GHEBEDE: dede dede
GHEBEDEN: hovesscheden dede
GHEBETEN: heten
GHEBIEDIJT: zijt
GHEBLEET: verbeet
GHEBOD: god
GHEBODE: gode gode
GHEBONDEN: honden wonden
GHEBOOT: doot
GHEBOREN: voren toren
GHEBRAUWEN: trauwen
GHEBREKEN: steken
GHEBUERE: muere
GHECNAGHET: bejaghet
GHEDAEN: bevaen ontfaen saen waen staen aneslaen ghevaen gaen staen vergaen ontgaen gaen bestaen onverdaen gaen gaen staen verstaen capelaen saen verstaen saen
GHEDAGHET: beclaghet
GHEDEDE: vrede
GHEDICHTE: lichte
GHEDIENT: vrient vrient
GHEDINGHE: carminghe dinghe bringhe
GHEDINGHET: beringhet
GHEDOCHTE: haghedochte
GHEDOE: daertoe
GHEDOGHEDE: poghede
GHEDOGHEN: hoghen hoghen oghen
GHEDRAGHEN: slaghen waghen
GHEDREGHEN: weghen versleghen jeghen
GHEDREVEN: bleven verheven
GHEETEN: bleeten
GHEGAEN: bevaen bestaen slaen
GHEGHEVEN: ghescreven
GHEHANDEN: tanden
GHEHEVEN: begheven
GHEHIDET: lijdet
GHEHOORT: woort
GHEHOUDEN: woude
GHEHUKE: struke
GHELACH: dach lach
GHELADEN: gheraden
GHELAET: vraet vraet quaet quaet
GHELAGHE: haghe
GHELATE: strate strate
GHELATEN: verwaten straten utermaten utermaten
GHELEDEN: leden
GHELEEDE: crede sceede beede
GHELEEDEN: sceeden
GHELEERT: apeert tybeert tybeert
GHELES: es
GHELESEN: wel
GHELIET: sciet
GHELIKE: rike
GHELOEPEN: becoepen hopen
GHELOGHEN: bedroghen bedroghen
GHELOVEN: hove boven roven hove roven
GHELUDE: pude
GHELUUT: huut huut huut
GHELYET: verriet
GHEMAC: sprac
GHEMAECT: gheraect
GHEMAENT: waent
GHEMAEX: haex
GHEMAKE: bake sprake sake
GHEMAKET: ghenaket
GHEMANC: bedwanc
GHEMEENE: cleene cleene
GHEMICKE: dicke
GHEMOET: goet goet doet
GHEMOETEN: groeten
GHEMOGHEN: ghevloghen
GHENADE: scade scaden rade scade scade scade
GHENADELIKE: mordadelike
GHENADEN: gheraden verraden verraden raden
GHENAECT: mesmaect
GHENAKET: ghemaket
GHEND: paerlement
GHENEEREN: verzweeren
GHENENT: covent
GHENEPEN: onbegrepen
GHENESEN: wesen wesen wesen
GHENINDE: bekinde
GHENOMEN: comen comen
GHENOOMT: verdoomt
GHENOUCH: onghevouch ghevouch drouch drouch louch drouch onghevouch
GHENOUGHEN: bedroughen
GHENT: paerkement
GHEORSAM: vernam
GHERADEN: gheladen ghenaden
GHERAECT: moedernaect ghemaect
GHERAKEN: maken aken
GHEREEDEN: leeden
GHEREET: leet leit breet weet weet
GHERNE: wernen scerne scherne
GHEROCHTE: toebrochte haghedochte
GHERONNEN: ghewonnen ghesponnen zonne ghewonnen
GHESACH: slach lach middach
GHESCEEDE: crede
GHESCIE: drie
GHESCIEN: sien ghesien vlien
GHESCIET: ontsiet niet niet niet
GHESCREVEN: lesen ghegheven gheven
GHESEIT: dorperheit
GHESELLE: felle felle velle
GHESELLEN: tellen tellen
GHESET: martinet martinet
GHESIEN: vlien ghescien
GHESINDE: vinde
GHESLACHTE: achte
GHESLEGHEN: pleghen
GHESMIDE: zijde
GHESPELEN: ghetelen
GHESPONNEN: gheronnen
GHESPROKEN: onghewroken uptebroken
GHESPRONGHEN: jonghen
GHESTAEN: gaen ontgaen ghevaen gaen
GHESTEKEN: treken spreken
GHESTILLE: wille wille
GHESTOLEN: molen verholen
GHESWEGHEN: weghen
GHETALE: male
GHETELEN: ghespelen
GHETEMEN: nemen
GHETIJDE: omblijde
GHETRAUWE: vrauwe vrauwe
GHEVAEN: ontgaen staen ghedaen ontgaen ghestaen saen ghevaen ghevaen
GHEVAL: overal sal al al overal
GHEVALLEN: allen allen allen
GHEVANE: ghane
GHEVAREN: bare daren
GHEVEN: leven leven leven leven bleven ghescreven
GHEVENE: levene
GHEVET: hevet
GHEVIELE: ziele
GHEVLOGHEN: hoghen ghemoghen
GHEVOUCH: louch ghenouch louch
GHEWAERLIKE: rike
GHEWAERT: reynaert
GHEWAN: man
GHEWANDE: scande
GHEWARE: harenthare
GHEWELT: velt velt
GHEWES: es
GHEWESEN: desen
GHEWIN: in daerin in in in daerin
GHEWINNE: minne minnen coninghinne
GHEWINNEN: binnen binnen binnen beghinnen coninghinnen
GHEWONE: sone
GHEWONNEN: gheronnen verjonnen gheronnen nonnen connen
GHEWONT: stont
GHEWOUDEN: houden
GHEWOUT: hout gout sout wout wout
GHEWRAKEN: bespraken
GHEWREKEN: bespreken breken
GHEWROCHTE: mochte
GHEWROKEN: versproken
GHEZWOREN: verloren tevoren
GHI: desen vry bi mi
GHIER: hier
GHINC: ontfinc jonghelinc hinc coninc hinc
GHINGHEN: bedwinghen zameninghen dinghen
GOD: ghebod spot zot
GODE: bode ghebode ghebode bode
GOEDERTIERE: dieren
GOEDERTIEREN: dieren
GOEM: boem boem oem oem
GOET: doet stoet doet stoet onvroet vroet ghemoet ghemoet stoet vroet bloet doet doet moet moet
GOETS: bloet
GOUD: houd
GOUDE: soude soude woude
GOUT: ghewout tsout
GRACHT: cracht nacht
GRAF: was
GRAM: began ontswam nam ram vernam ram vernam ram
GRANEN: tranen
GRAS: was was was was was
GRAVE: boucstave have
GRIEF: dief
GRIJSEN: wysen
GRIMBEERT: keert
GRIPEN: pipen
GROENE: coene
GROET: noet doot doet noet doot omboet
GROETEN: ghemoeten
GRONGAERDE: reynaerde
GROOT: doot noot steendoot bloot noot noot doot doot
GROTE: voeten
GROTEN: verstoten
HAER: waer waer
HAERDE: reynaerde
HAERWAERT: reynaert
HAEST: naest naest
HAEX: ghemaex
HAGHE: daghe daghe saghe slaghe slaghe ghelaghe
HAGHEDOCHTE: ghedochte mochte brochte gherochte
HAGHEN: laghen
HAKEN: huuttraken
HALF: calf
HALS: onghevals als hals hals
HAMEN: bequame scamen
HANE: wane vane wane verstane ghane
HANEN: polane danen
HANGHEN: vanghen
HANT: vant vant lant
HARE: mare jare elmare openbare
HARENTHARE: vare gheware openbare
HARSENDEN: kindren
HASE: blase ase
HAT: zat
HATE: barate
HATEN: honichraten
HATET: satet
HAVE: grave
HAWY: gawy
HEBBEN: rebben
HEBDI: mi
HECHT: recht
HEDEN: vriheden
HEEDE: onghereede
HEERE: eere eere zeere beere beere zeere eere eere zeere warelteere eere zeere eere eere beere
HEEREN: eeren eere leeren
HEESCH: vleesch
HEET: zweet
HEETEN: weten
HEIDEN: beiden
HEL: wel
HELLEN: quellen
HEM: bem bem nem bem bem nem bem bem bem bem
HEME: neme
HERMANNE: tebannen
HERMELIJNE: mine
HERMELINE: welpekine pine pine lijne pine pine
HERMELINEN: minen welpkinen welpkinen welpkinen
HERMIJTE: quijte
HERSENDEN: benden
HERTE: smerte
HETEN: weten weten ghebeten
HEVET: ghevet
HEYDE: seide
HEYDEN: versceiden zeide
HI: bi bi daerbi mi mi comedi
HIER: dier ghier mompelier dier vier lier dier cloesterbier dier bottelgier
HIERVOREN: horen
HIET: yet
HIJFTE: vijfste
HIJS: wijs
HINC: jonghelinc coninc ghinc dinc ghinc
HINDERWAERT: spaert
HINNEN: winnen
HO: domino
HODEVARE: jare vare
HOE: toe vroe vroe
HOECH: vloech
HOEDE: broede
HOEFT: verdoeft
HOEN: cappoen cappoen doen
HOENE: coene
HOERDE: scorde
HOERDEN: woerden
HOEVER: droever
HOF: lof orlof orlof lof
HOGHE: loghe hoghe hoghe
HOGHEN: ghedoghen ghevloghen ghedoghen
HOLE: dole
HONDEKIJN: rijn
HONDEN: verslonden stonden ghebonden
HONEN: sconen wederlonen
HONICHRATEN: haten maten utermaten
HONT: mont
HOOFSCHELIKE: rike
HOORDE: scorde
HOORDEN: scoorden
HOPEN: gheloepen
HORDEN: worden woorden
HORE: pryhore
HOREN: doren doren verloren worden verdoren verloren verdoren verdoren hiervoren
HOUD: goud
HOUDE: soude woude
HOUDEN: ghewouden souden mouden behouden mouden wouden
HOUT: onhout smout ghewout
HOVE: love love gheloven love orlove gheloven love
HOVESSCHEDEN: ghebeden
HU: nu nu nu nu nu nu nu nu nu
HULDE: sculde sculde sculde
HULSTERLOE: vroe soe
HUTEBROCHT: mesrocht
HUUS: manpertus manpertus muus muus manpertuus manpertuus manpertuus spiritus dominus manpertuus
HUUSE: muse
HUUT: overluut huut huut huut huut gheluut gheluut saluut gheluut
HUUTLAC: onghemac
HUUTTRAKEN: haken
IN: ghewin ghewin ghewin ghewin
INDAGING: naken moet mesval
INDERWAERT: spaert
INGAEN: ontfaen
INSTAC: brac
JA: na
JAER: waer waer daer daer
JAET: quaet slaet
JAGHEN: slaghen
JARE: hare ware hodevare
JAREN: waren
JEGHEN: ghedreghen
JONC: spronc
JONCHEEREN: keeren
JONGHE: dwonghe
JONGHELINC: hinc ghinc
JONGHEN: ghespronghen
JONNE: zonne
JONNEN: begonnen
JONSTE: conste
JORDANE: wane
JULOCKE: rocke rocke rocke
JULOCKEN: clocken
KARIJNEN: pinen
KEER: tsjaermeer
KEERDE: leerde
KEEREN: eeren eeren joncheeren
KEERT: grimbeert
KELE: vele vele vele vele
KELEN: spelen spele
KERKE: werke
KERREN: verren
KEYTIJF: wijf
KINDRE: mindre mindre
KINDREN: harsenden
KNECHT: recht
KNECHTE: rechte rechte
KRIEKEPIT: dit
KRIEKEPUTTE: nutte
LACH: sach bejach plach sach slach sach ghelach ghesach
LACHTER: achter
LACHTRE: achtre achtre
LADEN: beraden
LAGHE: daghe daghe daghe
LAGHEDEN: bejagheden
LAGHEN: saghen saghen haghen
LAMFREYDE: seide beide
LAMMEN: mammen
LANC: zanc ganc danc ganc zonneupganc
LANCKEN: dancken
LANCST: anxt
LANCVOET: cloet
LANDE: sande
LANT: vant vant hant serjant vant
LANTERNEN: ogernen
LAS: was was was
LAT: gat
LATEN: maten straten utermaten
LECHT: echt
LEDE: dede eerchede vrede mede
LEDEN: gheleden dede
LEEDE: beede
LEEDEN: ghereeden
LEERDE: keerde
LEEREN: tonneeren heeren
LEERT: tybeert
LEET: ghereet weet weet weet wreet
LEGHET: ontweghet
LEIT: ghereet
LESEN: ghescreven wesen
LESENE: wesene
LETTELKIJN: zijn
LEVEN: begheven vergheven vergheven neve gheven vergheven gheven gheven vergheven begheven gheven
LEVENE: zevene ghevene
LEYE: meye
LICHTE: ghedichte
LICHTEN: dichten
LIEDE: sciede
LIEDEN: berieden
LIEF: dief dief dief dief brief brief
LIEGHEN: bedrieghen
LIEP: diep diep
LIER: dier dier dier hier
LIERE: riviere
LIET: niet niet
LIEVE: brieve
LIJCTEEKINE: stillekine
LIJDEN: tijden zijden zijden
LIJDET: ghehidet
LIJF: wijf wijf wijf wijf wijf wijf wijf
LIJNE: pine pijne pine hermeline
LISTE: wiste
LIVE: wive wive wive
LOEF: roef
LOEPEN: becoepen cnoepen becoepen becoepen
LOF: hof hof
LOGHE: hoghe
LONEN: sconen cronen
LONNEN: ontgonnen
LOS: vos
LOSENGIEREN: manieren
LOUCH: ghevouch ghevouch ghenouch
LOVE: hove hove hove hove
LUST: best
LYOEN: doen doen mesdoen
MACH: dach versach dach dach ontsach sach dach dach
MAECH: traech traech
MAECTE: waecte
MAENDE: waende
MAENT: bewaent
MAERC: overstaerc waerc
MAERKEN: baerken
MAGHE: claghe saghe domsdaghe
MAGHEN: daghen claghen claghen verdraghen bedraghen bedragen overeendraghen draghen belaghen
MAGHET: draghet
MAKEN: saken gheraken saken taken staken
MALE: ghetale portegale dale wale
MALSCH: valsch
MAMMEN: lammen
MAN: nam ghewan ban can stan an dan an dan can
MANGHELINGHE: dinghen
MANIEREN: losengieren
MANPERTUS: huus huus
MANPERTUUS: huus huus huus huus
MARE: hare baren bare ware
MARTINET: gheset vet bet gheset
MAT: tgat
MATEN: laten honichraten
MATER: cater
MEDE: vrede dede dede vrede lede dede
MEE: twee twee
MEER: canticleer zeer wederkeer eer
MEERE: eere eere
MENICHFOUDE: woude soude coude
MERKEDI: bi
MERREDE: errede
MESBARE: ware
MESBAREN: ontfaren
MESDADEN: raden verraden
MESDAEN: gaen staen dwaen verstaen verstaen staen ontfaen
MESDAET: verstaet quaet
MESDOEN: lyoen
MESLIET: niet
MESMAECT: ghenaect
MESPRIJSEN: wijsen
MESROCHT: hutebrocht
MESSE: zesse wildernesse
MESVAL: indaging
MESVOERT: verhoert
METTIEN: versien
MEYE: leye
MI: zi zi vry daghe wy walschedi di bi vry zi bi zidi ghi zi vry twi hi hi sidi belghedi hebdi sechdi vry vry
MICKE: dicke
MICKEN: ontscricken
MIDDACH: ghesach
MIEDE: sciede
MIJN: zijn zijn
MILDE: wilde
MILE: wijle wile
MINDRE: kindre kindre
MINE: zine hermelijne
MINEEREN: rampineeren
MINEN: hermelinen
MINNE: ghewinne
MINNEN: ghewinne
MOCHT: brocht
MOCHTE: sochte brochte onzochte haghedochte sochte ghewrochte dochte brochte
MOEDE: bloede
MOEDERNAECT: gheraect
MOET: indaging doet doet bestoet vroet onvroet goet doet goet
MOGHEN: bedroghen bedroghen
MOLEN: ghestolen
MOLENMAN: an
MOMPELIER: hier
MONDEN: stonden
MONT: hont stont stont stont
MOORT: woort voort voort
MORDADELIKE: ghenadelike
MORDENARE: ware
MORDENAREN: ontvaren
MORDENEERE: ombeere
MORT: wort
MOS: vos
MOUDEN: houden houden
MOYE: vernoye vernoye
MOYEN: vernoyen vernoyen scoyen vernoyen
MUERE: scuere ghebuere avontuere scuere creatuere scueren
MULEN: dulen
MUSE: huuse
MUUS: huus huus
MUZEELE: deele
MYNNEN: coninghinne
NA: ontga va versta ja
NACHT: gracht bedacht cracht cracht cracht cracht
NACHTE: wachte
NAER: zwaer
NAEST: haest haest
NAET: slaet
NAKEDE: smakede
NAKEN: indaging verzoening
NAM: man gram quam
NAME: scame ombequame scame
NAMEN: quamen bequamen quamen
NEDER: weder
NEEN: been
NEGHEEN: steen
NEM: hem hem
NEME: heme
NEMEN: ghetemen
NEMMEE: ontwee
NEMMERMEE: overzee overzee overzee
NEMMERMEER: wederkeer
NESE: pese
NEVE: leven bleve beve vergheve screve
NEVEN: bleven
NIEMARE: ware ware bare
NIET: ghesciet yet beriet yet vliet siet yet mesliet ghesciet verriet beriet sciet ghesciet sciet liet beghiet liet bespiet riet yet
NIJT: vermalendijt
NOCHTAN: daeran can
NOENE: doene
NOET: groet groet doot
NONNEN: begonnen ghewonnen
NOODE: bloode
NOOMT: roomt
NOOT: groot doot groot groot
NOSTER: cloester
NU: hu hu hu hu hu hu hu hu hu
NUTTE: kriekeputte
NYE: toezye
OEM: boem goem boem goem
OGERNEN: lanternen
OGHEN: ghedoghen
OMBEDECT: trect
OMBEERE: mordeneere
OMBEQUAME: name
OMBIEDEN: rieden
OMBLIJDE: ghetijde
OMBOET: groet
OMMACHT: cracht cracht
OMME: zomme
OMMELOEPEN: coepen
OMTRENT: convent
ONBAREN: varen
ONBEGREPEN: ghenepen
ONBESCAVEN: raven
ONDAET: verstaet
ONDER: wonder
ONDERGAEN: saen saen
ONGHEMAC: zac sprac stac huutlac
ONGHENADE: spade
ONGHEREC: strec strec
ONGHEREEDE: beede heede
ONGHEREET: weet
ONGHESONT: stont
ONGHETRAUWE: vrauwe
ONGHEVAL: al al ghal sal al
ONGHEVALS: hals
ONGHEVOUCH: ghenouch ghenouch
ONGHEWROKEN: ghesproken tebroken
ONGHIERE: vieren
ONHOUT: hout
ONNEERT: tybeert
ONSOCHTE: wederbrochte
ONSOETE: voete
ONTBANT: vant
ONTBONDEN: orconden
ONTDELVEN: selven
ONTFAEN: ghedaen angaen ingaen slaen gaen gaen saen mesdaen gaen
ONTFAERMEDE: carmede
ONTFAERMEN: bescaermen
ONTFAREMDE: becaremde
ONTFAREN: mesbaren sparen
ONTFINC: coninc ghinc
ONTGA: na
ONTGAEN: ghevaen ghestaen ghevaen waen gaen ghedaen saen
ONTGAN: an
ONTGHELDEN: scelden scelden
ONTGONNEN: lonnen
ONTHERVET: verdervet
ONTHOUDEN: scouden
ONTRAN: ban
ONTSACH: mach
ONTSCOYDE: afvloyde
ONTSCRICKEN: micken
ONTSIET: ghesciet
ONTSPRANC: danc
ONTSWAM: gram
ONTVAREN: mordenaren
ONTWEE: nemmee
ONTWEGHET: leghet
ONTWENDEN: blenden
ONTWISSCHEN: visschen
ONVERDAEN: ghedaen
ONVERVAERDE: reynaerde
ONVERVAERT: reynaert waert
ONVROE: zoe
ONVROET: goet moet
ONWAERT: vaert reynaert
ONWILLE: aprille
ONZOCHTE: mochte
OPENBARE: scare harenthare ware spare vare blare hare
ORCONDE: zonde
ORCONDEN: ontbonden
ORLOF: hof hof
ORLOVE: hove
OVERAL: gheval sal sal val gheval
OVERDADE: rade
OVERDAET: staet quaet raet quaet
OVEREENDRAGHEN: maghen
OVEREENE: beene
OVERLUUT: huut
OVERSTAERC: maerc
OVERZEE: nemmermee nemmermee wee nemmermee wee
PADE: stade
PAERC: staerc
PAERKEMENT: ghent
PAERLEMENT: ghend
PAS: was
PAST: vast
PAT: zat zat
PAYMENT: daeromtrent
PEELGRIJN: ysingrijn ysingrijn ysingrijn ysengrijn ysingrijn
PERDITE: quite
PERDOEN: scoen
PERTRIJSEN: spijsen
PESE: nese
PIJNE: lijne
PINE: slavine ysingrine anschine lijne lijne sine hermeline zine wostine ysingrine hermeline hermeline hermeline beline
PINEN: karijnen zinen zinen zine clockelijnen
PIPEN: gripen
PLACH: lach
PLADIJSE: wijsen
PLADIJSENGRAET: quaet
PLAYDIEREN: dieren
PLECHT: recht
PLEGHEN: versleghen ghesleghen stelen afghesleghen
PLUMEN: rumen
POGHEDE: ghedoghede
POLANE: hanen
PORTEGALE: male
PRIJSE: spijse spijse
PROCHIANE: vane slane
PRYHORE: hore
PUDE: ghelude
QUADE: rade
QUAET: pladijsengraet baraet overdaet raet raet gaet ghelaet raet raet daet ghelaet overdaet jaet gaet mesdaet
QUAM: tam vernam vernam nam ram vernam ram ram vernam vernam ram
QUAMEN: namen vernamen tsamen namen
QUELLEN: hellen
QUIJTE: hermijte
QUITE: perdite
RADE: overdade raden dade dade ghenade scade dade quade
RADEN: rade mesdaden scaden ghenaden
RAET: vraet daet quaet dagheraet baraet overdaet quaet gaet quaet quaet staet gaet vraet vraet
RAKE: stake
RAM: quam gram quam gram quam quam gram
RAMPINEEREN: mineeren
RAMPINEREN: ryviere
RAT: dat
RAUWE: vrouwe
RAUWEN: trauwen trauwen trauwen
RAVEN: onbescaven scaven
REBBEN: hebben
RECHT: knecht plecht echt echt hecht
RECHTE: knechte knechte
REYNAERD: vervaert
REYNAERDE: haerde grongaerde baerde vaerde baerde baerde onvervaerde baerde cuaerde
REYNAERDINE: gaerdeline
REYNAERDYE: scampye
REYNAERT: onvervaert staert waert waert onwaert waert vaert ghewaert vaert waert spaert waert haerwaert waert achterwaert waert waert waert daerwaert vervaert vaert vaert vaert wart waert vaert baert cuaert vaert vaert
RICHT: stallicht
RIEDEN: ombieden
RIEPEN: sliepen
RIES: dies
RIET: niet
RIJME: ysengrijne ysingrine
RIJN: hondekijn
RIJNC: coninc
RIJNE: sine
RIJSEN: wijsen
RIJSERE: dysere
RIKE: hoofschelike coninclike verweendelike ghelike verholenlike ghewaerlike vriendelike verholenlike eewelike
RIKER: spijker
RINC: coninc
RINGHE: dinghe
RIVIERE: diere sciere liere diere
ROCKE: julocke julocke julocke
RODEN: dooden
ROEF: stoef loef
ROEREN: voeren
ROET: doot
ROOMT: noomt
ROSSEEL: butseel
ROVEN: gheloven gheloven
RUGGHE: brugghe
RUMEN: plumen
RYBAUT: saut
RYVIERE: rampineren
SACH: lach lach dach lach mach dach dach
SADEN: beraden
SAEN: staen ghedaen ondergaen ghevaen gaen gaen gaen bestaen vaen gaen ontgaen ondergaen ghedaen ontfaen gaen ghedaen
SAGHE: haghe maghe daghe
SAGHEN: laghen laghen
SAKE: ghemake
SAKEN: maken smaken maken
SAL: overal gheval overal al al al ongheval
SALUUT: huut
SANC: ganc
SANDE: lande
SASSEN: dassen
SAT: dat gat stat
SATEN: straten
SATET: hatet
SAUT: rybaut
SCADE: ghenade ghenade rade ghenade ghenade
SCADELOES: altoes
SCADEN: ghenade braden beraden raden
SCAME: name name
SCAMEN: hamen
SCAMP: cramp
SCAMPYE: reynaerdye
SCANDE: ghewande
SCANDEN: tanden blanden
SCARE: openbare
SCAT: dat stat dat dat gat stat dat dat besat bat
SCAVEN: raven
SCEEDE: gheleede
SCEEDEN: gheleeden
SCEEN: een been
SCEIDEN: beiden
SCELDEN: ontghelden ontghelden
SCERNE: gherne
SCHEEN: been
SCHERNE: gherne taverne
SCIEDE: miede liede
SCIERE: riviere viere
SCIET: niet niet gheliet
SCIJNCKEN: drineken
SCINEN: carine
SCOEN: doen doen doen doen doen perdoen
SCONE: crone
SCONEN: honen lonen
SCOORDEN: hoorden
SCORDE: hoorde hoerde
SCOUDEN: onthouden
SCOYEN: moyen
SCRAVEN: begraven begraven
SCREVE: neve
SCUERE: muere muere
SCUEREN: muere
SCULDE: hulde hulde hulde
SCUVUUT: cruut
SECHDI: bi wy mi
SEIDE: lamfreyde heyde
SELVEN: ontdelven
SENT: staerblent
SERJANT: tehant lant
SIDI: mi
SIEN: ghescien
SIET: niet yet
SIJN: zwijn
SIJT: vermaledijt
SINE: wostine pine rijne
SINNE: beghinnehofdag
SLACH: cruusstaf lach ghesach dach toesach
SLAEN: ontfaen vaen ghegaen
SLAENDE: gaende
SLAET: naet jaet
SLAGHE: haghe haghe
SLAGHEN: ghedraghen jaghen
SLANE: vane prochiane
SLAVINE: pine
SLIEPEN: riepen
SLOUCH: bedrouch
SMAKE: bake
SMAKEDE: nakede
SMAKEN: saken
SMAREN: waren
SMEEKEN: eecken
SMERTE: herte
SMOUT: hout
SNEET: wreet
SNEL: wel
SOCHTE: mochte mochte
SOE: hulsterloe
SOETE: voete
SOETEN: voeten
SOME: come
SONE: ghewone
SOUCKEN: boucken
SOUDE: woude woude menichfoude woude boude woude woude houde goude woude goude woude woude
SOUDEN: houden wouden wouden
SOUT: ghewout
SPADE: onghenade bade
SPAERT: waert reynaert inderwaert hinderwaert
SPARE: openbare
SPAREN: waren varen ontfaren
SPELE: vele vele kelen
SPELEN: kelen
SPIJKER: riker
SPIJSE: prijse prijse
SPIJSEN: pertrijsen
SPIRITUS: huus
SPISE: wijse
SPOT: zot god
SPRAC: onghemac ghemac
SPRAKE: wrake ghemake
SPRANC: wanc danc
SPREKEN: treken treken wreken ghesteken
SPRONC: jonc
STAC: onghemac
STADE: pade
STAEN: saen mesdaen ghedaen vergaen gaen ghevaen ghedaen mesdaen vaen waen ghedaen gaen gaen
STAERBLENT: sent
STAERC: paerc
STAERF: waerf
STAERT: reynaert waert
STAET: overdaet raet gaet gaet gaet aflaet
STAF: gaf
STAKE: rake
STAKEN: traken maken
STALLICHT: richt
STAN: man
STAT: zat sat scat scat
STAVE: bave
STEEN: negheen
STEENDOOT: groot
STEENE: alleene cleene
STEET: weet
STEKEN: ghebreken
STELEN: pleghen
STIERNE: vierne
STILLE: wille wille wille wille wille
STILLEKINE: lijcteekine beline
STOEF: roef
STOET: goet goet bloet goet voet
STONDEN: wonden zonden wonden vonden vonden vonden honden monden
STONT: cont onghesont mont mont mont ghewont
STOVEN: doven
STRATE: ghelate gate barate ghelate
STRATEN: ghelaten utermaten laten saten gelaten
STREC: ongherec ongherec
STRIJDE: blide
STRO: also
STROE: zoe
STROEM: boem
STROP: crop
STRUKE: ghehuke
STUPEN: crupen
TAKEN: maken
TALE: wale dale dale dale wale wale
TAM: quam
TANDEN: ghehanden scanden
TANT: vant
TAVERNE: scherne
TEBANNEN: hermanne
TEBLAUWEN: bescauwen
TEBROKEN: onghewroken beloken
TEHANT: zant serjant busant vant zant
TELEN: bevelen
TELLEN: ghesellen ghesellen
TETENE: wetene
TEVOREN: toren verloren verloren verloren ghezworen bescoren toren verloren verloren
TGAT: mat
TIENEN: verdienen
TIJDEN: lijden
TIJT: begheerdijt zijt zijt
TLEVEN: begheven
TLIJF: wijf
TMIJN: zijn
TOE: doe hoe doe
TOEBROCHTE: gherochte
TOESACH: slach
TOEZYE: nye
TONNEEREN: leeren
TOREN: tevoren verloren gheboren tevoren
TRAECH: maech maech
TRAKEN: staken
TRANEN: granen
TRAUWE: vrouwe vrouwe vrauwe
TRAUWEN: rauwen rauwen rauwen ghebrauwen vrauwen vrauwen
TRECT: ombedect
TREKEN: spreken spreken ghesteken
TROUWEN: vrouwen
TSAMEN: quamen
TSJAERMEER: keer
TSOUT: gout
TUNE: brune
TUUN: bruun bruun
TWEE: wee mee mee
TWI: mi
TWY: vry
TYBEERT: wederkeert gheleert verzeert leert gheleert onneert
TYECELIJN: everzwijn
UPGAET: aflaet
UPHEVEN: begheven
UPHILDEN: wilden
UPLASET: versadet
UPTEBROKEN: ghesproken
UTERMATEN: honichraten straten gate ghelaten ghelaten laten
VA: na
VADER: algader allegader algader algader algader
VADRE: algadre allegadre
VAEN: slaen staen saen
VAER: waer
VAERDE: reynaerde
VAERT: onwaert waert vervaert reynaert reynaert waert reynaert reynaert reynaert cuwaert claert waert reynaert reynaert reynaert
VAL: overal
VALDORE: vore
VALSCH: malsch
VANE: slane prochiane ane hane
VANGHEN: hanghen
VANT: crayant hant hant bewant tant lant lant tehant verslant lant ontbant
VARE: ware harenthare openbare hodevare daernare ware ware autare ware ware
VAREN: waren onbaren claren sparen
VAST: gast gast past
VASTE: gaste gaste
VEDERSLACH: cleenebejach
VEL: wel wel wel wel
VELE: kele spele kele spele kele kele
VELLE: gheselle
VELT: ghewelt ghewelt
VENISOEN: doen
VERBEET: wreet ghebleet wreet
VERBIT: dit
VERBOLGHEN: volghen
VERCOREN: voren
VERDERVET: onthervet
VERDIENEN: tienen
VERDIENT: vrient
VERDOEFT: hoeft
VERDOOMT: ghenoomt
VERDOORT: voort
VERDOREN: horen voren horen horen
VERDRAGHEN: maghen
VERDREEF: bleef
VERGAEN: staen bestaen ghedaen
VERGHEVE: neve
VERGHEVEN: leven leven leven bleven leven
VERGHINC: dinc
VERHEVEN: ghedreven
VERHOERDE: andwoerde
VERHOERT: mesvoert
VERHOGHET: doghet
VERHOLEN: ghestolen bestolen volen
VERHOLENLIKE: rike rike
VERJONNEN: ghewonnen
VERLIES: dies dies
VERLOREN: horen voren tevoren bescoren tevoren tevoren toren horen ghezworen welgheboren voren voren verzworen tevoren tevoren
VERMALEDIJT: sijt
VERMALENDIJT: nijt
VERMALENDYEN: castyen
VERMENDOYS: bloys
VERMOCHTE: dochte
VERNAM: quam quam quam gram gheorsam quam gram quam
VERNAMEN: quamen
VERNOMEN: comen comen comen comen
VERNOYE: moye moye
VERNOYEN: moyen moyen moyen
VERRADEN: ghenaden ghenaden daden mesdaden
VERRE: erre erre erre erre
VERREN: kerren
VERRIET: niet ghelyet
VERSACH: mach
VERSADET: uplaset
VERSCEIDEN: heyden
VERSEERT: verstorbeert
VERSIEN: mettien dien
VERSLANT: vant
VERSLEGHEN: pleghen ghedreghen
VERSLONDEN: honden
VERSPROKEN: ghewroken
VERSTA: na
VERSTAEN: mesdaen mesdaen ghedaen gaen gaen ghedaen
VERSTAET: mesdaet baraet ondaet
VERSTANE: hane
VERSTOET: vroet
VERSTORBEERT: verseert
VERSTOTEN: groten
VERTELLEN: fellen
VERVAERT: reynaerd vaert wart waert reynaert waert waert waert
VERWATEN: baraten ghelaten
VERWEENDELIKE: rike
VERWIJT: zijt
VERWINNEN: coninghinne
VERZEERT: tybeert
VERZOENING: naken
VERZWEEREN: gheneeren
VERZWOREN: verloren
VESTE: beste
VET: bet wet martinet
VIER: hier
VIERE: sciere
VIEREN: onghiere
VIERNE: stierne
VIJFSTE: hijfte
VINC: aermijnc
VINDE: ghesinde
VINGHEREN: zwinghen
VISSCHEN: ontwisschen
VIVEN: wiven
VLEESCH: heesch
VLIEN: ghesien ghescien
VLIET: niet
VLOECH: hoech
VLOER: zwoer zwoer voer
VLOGEL: voghel
VLUCHT: aflaet
VOER: zwoer vloer
VOEREN: roeren
VOERTBRINGHEN: wandelinghen
VOERTDRAGHEN: daghen
VOERTTRAC: dat
VOET: stoet
VOETE: cloete onsoete soete
VOETEN: soeten grote
VOGHEL: vlogel
VOGHELIJN: zijn
VOGHELINE: ermeline
VOLEN: verholen
VOLGHEN: verbolghen
VONDEN: stonden stonden stonden
VOORT: woort moort moort verdoort
VORE: valdore
VOREN: verloren gheboren verdoren vercoren verloren verloren
VORST: worst worst
VORWAERTMEER: cantecleer
VOS: los mos
VRAET: raet ghelaet ghelaet raet raet
VRAUWE: ghetrauwe onghetrauwe trauwe ghetrauwe wederscauwe
VRAUWEN: trauwen trauwen
VREDE: ghedede dede mede lede mede
VRIENDELIKE: rike
VRIENT: ghedient dient ghedient verdient
VRIHEDEN: heden
VRO: also
VROE: doe doe hoe hulsterloe hoe
VROEDE: broede
VROET: doet goet goet verstoet doet moet
VROME: willecome willecome
VROMEN: comen comen comen wedercome
VROUWE: trauwe rauwe trauwe
VROUWEN: trouwen
VRY: mi mi ghi zij twy mi mi mi
VULBRINGHEN: dinghen
VULSCREVEN: bleven
VYERGAT: wat
WACHTE: nachte
WAECTE: maecte
WAEN: ghedaen gaen bevaen bestaen ontgaen staen
WAENDE: maende
WAENT: ghemaent
WAER: jaer jaer daer daer haer zwaer haer vaer daer daer
WAERC: maerc
WAERF: staerf
WAERT: cantaert onvervaert reynaert reynaert reynaert vaert staert spaert reynaert vervaert reynaert vaert reynaert reynaert reynaert reynaert begaert cuwaert reynaert vervaert vervaert vaert vervaert
WAGHEN: claghen ghedraghen draghen
WALE: tale abstale wedertale tale fel tale male
WALSCHEDI: mi
WANC: spranc
WANDELEN: andren andren
WANDELINGHE: ballinghe
WANDELINGHEN: voertbringhen
WANE: hane hane jordane
WANEN: danen
WARE: clusenare niemare mare mordenare jare vare elmare niemare ghebare openbare vare vare zware vare vare mesbare
WARELTEERE: heere
WAREN: jaren sparen elmaren varen baren baren smaren
WARP: alrescaerpst
WART: vervaert reynaert
WAS: das das las das las graf gras pas das gras das das das das das das gras gras gras das das las
WAT: zat vyergat
WATER: cater
WEDER: neder
WEDERBROCHTE: onsochte
WEDERCOME: vromen
WEDERKEER: nemmermeer emmermeer meer
WEDERKEERT: tybeert
WEDERLONEN: honen
WEDERSCAUWE: vrauwe
WEDERTALE: wale
WEE: twee overzee overzee
WEET: leet leet steet leet onghereet ghereet ghereet
WEGHEN: ghedreghen ghesweghen
WEKEN: deken
WEL: bijspel vel vel fel ghelesen fel vel vel hel snel
WELDADEN: baden
WELGHEBOREN: verloren
WELPEKIJNEN: ermelijnen
WELPEKINE: hermeline
WELPKINE: woestine
WELPKINEN: hermelinen hermelinen hermelinen
WERC: clerc clerc
WERKE: kerke
WERNEN: gherne
WESEN: ghenesen desen desen ghenesen desen desen ghenesen lesen
WESENE: lesene
WET: vet
WETEN: heeten afghebeten heten heten
WETENE: tetene
WIJDE: blide
WIJDELANCKEN: dancken
WIJF: lijf lijf keytijf lijf lijf lijf lijf lijf tlijf
WIJLE: mile filye
WIJLEN: bijlen
WIJS: hijs
WIJSE: spise
WIJSEN: mesprijsen pladijse rijsen
WILDE: milde
WILDEN: uphilden
WILDERNESSE: messe
WILE: mile
WILLE: ghestille stille ghestille stille stille stille stille
WILLECOME: vrome vrome
WINNEN: hinnen
WISTE: liste
WIT: dit
WIVE: live live live
WIVEN: viven
WOERDEN: hoerden andwoerden
WOESTINE: welpkine
WONDEN: stonden stonden ghebonden
WONDER: onder
WOORDEN: horden
WOORT: ghehoort moort voort
WORDEN: horen horden
WORPE: dorpe
WORST: vorst vorst
WORT: mort
WOSTINE: sine pine
WOUDE: soude menichfoude soude soude soude ghehouden soude soude houde coude goude soude soude
WOUDEN: souden souden houden
WOUT: ghewout ghewout
WRAKE: sprake
WREET: verbeet verbeet sneet leet
WREKEN: spreken
WROCHTE: brochte
WULFINNE: zinne
WY: mi zi sechdi
WYSEN: grijsen
YET: niet niet niet siet niet hiet
YSENGRIJN: peelgrijn
YSENGRIJNE: rijme
YSINGRIJN: peelgrijn peelgrijn peelgrijn peelgrijn
YSINGRINE: pine rijme pine
ZAC: onghemac
ZAKE: brake
ZAMENINGHEN: ghinghen
ZANC: lanc
ZANT: tehant tehant
ZAT: wat dat pat pat stat hat
ZEDE: dede dede
ZEER: meer
ZEERE: heere heere heere heere eere
ZEIDE: heyden
ZESSE: messe
ZEVENE: levene
ZI: mi mi mi wy mi
ZIDI: mi
ZIELE: gheviele
ZIJ: vry
ZIJDE: ghesmide
ZIJDEN: lijden lijden
ZIJN: mijn anschijn voghelijn mijn tmijn belijn lettelkijn belijn
ZIJNS: belijns
ZIJT: delijt ghebiedijt tijt verwijt tijt
ZIN: beghin
ZINE: mine pinen fine pine
ZINEN: pinen pinen
ZINGHEN: bringhen
ZINNE: coninghinne coninghinne coninghinne coninghinne coninghinne wulfinne coninghinne coninghinne
ZINNEN: coninghinne
ZOE: onvroe stroe
ZOENE: doene coene
ZOENEN: comen
ZOMEN: comen
ZOMME: omme
ZONDE: orconde
ZONDEN: stonden conden
ZONNE: gheronnen jonne
ZONNEN: begonnen
ZONNEUPGANC: lanc
ZORGHE: borghe
ZORGHEN: borghen
ZOT: spot god
ZWAER: daer daer naer waer
ZWARE: bare clusenare ware
ZWEET: heet
ZWIJN: sijn
ZWINGHEN: vingheren
ZWOER: vloer vloer voer

